%%%%%%%%%
%%%G  P%%
%%%    %%
%%%%%%%%%
% % % % %
%%%%%%%%%